{
  "name": "TWINS_0001 by LEMONY",
  "vendorProductId": 1280901121,
  "macros": [
    "{KC_LGUI, KC_LSFT, KC_LCTL, KC_4}",
    "",
    "",
    "",
    "",
    "",
    "",
    "",
    "",
    "",
    "",
    "",
    "",
    "",
    "",
    ""
  ],
  "layers": [
    [
      "KC_T",
      "KC_R",
      "KC_E",
      "KC_W",
      "KC_Q",
      "KC_ESC",
      "KC_NO",
      "KC_G",
      "KC_F",
      "KC_D",
      "KC_S",
      "KC_A",
      "KC_TAB",
      "KC_NO",
      "KC_B",
      "KC_V",
      "KC_C",
      "KC_X",
      "KC_Z",
      "KC_LSFT",
      "KC_NO",
      "MO(1)",
      "KC_DEL",
      "MO(3)",
      "KC_LCTL",
      "KC_LALT",
      "KC_LGUI",
      "KC_SPC",
      "KC_Y",
      "KC_BSPC",
      "KC_P",
      "KC_O",
      "KC_I",
      "KC_U",
      "KC_Y",
      "KC_H",
      "KC_QUOT",
      "KC_SCLN",
      "KC_L",
      "KC_K",
      "KC_J",
      "KC_H",
      "KC_NO",
      "KC_ENT",
      "KC_SLSH",
      "KC_DOT",
      "KC_COMM",
      "KC_M",
      "KC_N",
      "MO(2)",
      "KC_RGHT",
      "KC_UP",
      "KC_DOWN",
      "KC_LEFT",
      "KC_EQL",
      "KC_MINS"
    ],
    [
      "KC_5",
      "KC_4",
      "KC_3",
      "KC_2",
      "KC_1",
      "KC_TRNS",
      "KC_NO",
      "KC_TRNS",
      "KC_TRNS",
      "KC_TRNS",
      "KC_TRNS",
      "KC_TRNS",
      "KC_TRNS",
      "KC_NO",
      "KC_TRNS",
      "KC_TRNS",
      "MACRO00",
      "KC_TRNS",
      "KC_TRNS",
      "KC_TRNS",
      "KC_TRNS",
      "KC_TRNS",
      "KC_TRNS",
      "KC_TRNS",
      "KC_TRNS",
      "KC_TRNS",
      "KC_TRNS",
      "KC_TRNS",
      "KC_TRNS",
      "KC_TRNS",
      "KC_0",
      "KC_9",
      "KC_8",
      "KC_7",
      "KC_6",
      "KC_TRNS",
      "KC_TRNS",
      "KC_TRNS",
      "KC_6",
      "KC_5",
      "KC_4",
      "KC_TRNS",
      "KC_TRNS",
      "KC_TRNS",
      "KC_TRNS",
      "KC_3",
      "KC_2",
      "KC_1",
      "KC_TRNS",
      "KC_TRNS",
      "KC_TRNS",
      "KC_TRNS",
      "KC_TRNS",
      "KC_TRNS",
      "KC_0",
      "KC_TRNS"
    ],
    [
      "KC_PERC",
      "KC_DLR",
      "KC_HASH",
      "KC_AT",
      "KC_EXLM",
      "KC_TILD",
      "KC_NO",
      "KC_LPRN",
      "KC_LBRC",
      "KC_LCBR",
      "KC_TRNS",
      "KC_TRNS",
      "KC_TRNS",
      "KC_NO",
      "KC_TRNS",
      "KC_TRNS",
      "KC_TRNS",
      "KC_TRNS",
      "KC_TRNS",
      "KC_TRNS",
      "KC_TRNS",
      "KC_TRNS",
      "KC_TRNS",
      "KC_TRNS",
      "KC_TRNS",
      "KC_TRNS",
      "KC_TRNS",
      "KC_TRNS",
      "KC_TRNS",
      "KC_TRNS",
      "KC_RPRN",
      "KC_LPRN",
      "KC_ASTR",
      "KC_AMPR",
      "KC_CIRC",
      "KC_TRNS",
      "KC_GRV",
      "KC_PIPE",
      "KC_TRNS",
      "KC_RCBR",
      "KC_RBRC",
      "KC_RPRN",
      "KC_TRNS",
      "KC_TRNS",
      "KC_BSLS",
      "KC_TRNS",
      "KC_TRNS",
      "KC_TRNS",
      "KC_TRNS",
      "KC_TRNS",
      "KC_TRNS",
      "KC_TRNS",
      "KC_TRNS",
      "KC_TRNS",
      "KC_TRNS",
      "KC_TRNS"
    ],
    [
      "KC_TRNS",
      "KC_TRNS",
      "KC_TRNS",
      "KC_TRNS",
      "KC_TRNS",
      "KC_TRNS",
      "KC_NO",
      "KC_TRNS",
      "KC_TRNS",
      "KC_TRNS",
      "KC_TRNS",
      "KC_TRNS",
      "KC_TRNS",
      "KC_NO",
      "KC_TRNS",
      "KC_TRNS",
      "KC_TRNS",
      "KC_TRNS",
      "KC_TRNS",
      "KC_TRNS",
      "KC_TRNS",
      "KC_TRNS",
      "KC_TRNS",
      "KC_TRNS",
      "KC_TRNS",
      "KC_TRNS",
      "KC_TRNS",
      "KC_TRNS",
      "KC_TRNS",
      "KC_TRNS",
      "KC_TRNS",
      "KC_TRNS",
      "KC_TRNS",
      "KC_TRNS",
      "KC_TRNS",
      "KC_TRNS",
      "KC_TRNS",
      "KC_TRNS",
      "KC_TRNS",
      "KC_TRNS",
      "KC_TRNS",
      "KC_TRNS",
      "KC_TRNS",
      "KC_TRNS",
      "KC_TRNS",
      "KC_TRNS",
      "KC_TRNS",
      "KC_TRNS",
      "KC_TRNS",
      "KC_TRNS",
      "KC_TRNS",
      "KC_TRNS",
      "KC_TRNS",
      "KC_TRNS",
      "KC_TRNS",
      "KC_TRNS"
    ]
  ]
}