{
  "name": "TWINS_0002 by LEMONY",
  "vendorProductId": 1280901122,
  "macros": [
    "{KC_LGUI,KC_LSFT,KC_S}",
    "",
    "",
    "",
    "",
    "",
    "",
    "",
    "",
    "",
    "",
    "",
    "",
    "",
    "",
    ""
  ],
  "layers": [
    [
      "KC_ESC",
      "KC_Q",
      "KC_W",
      "KC_E",
      "KC_R",
      "KC_T",
      "KC_NO",
      "KC_TAB",
      "KC_A",
      "KC_S",
      "KC_D",
      "KC_F",
      "KC_G",
      "KC_NO",
      "KC_LSFT",
      "KC_Z",
      "KC_X",
      "KC_C",
      "KC_V",
      "KC_B",
      "KC_NO",
      "KC_LCTL",
      "KC_LALT",
      "KC_LGUI",
      "KC_NO",
      "KC_DEL",
      "MO(1)",
      "KC_SPC",
      "KC_BSPC",
      "KC_P",
      "KC_O",
      "KC_I",
      "KC_U",
      "KC_Y",
      "KC_NO",
      "KC_QUOT",
      "KC_SCLN",
      "KC_L",
      "KC_K",
      "KC_J",
      "KC_H",
      "KC_NO",
      "KC_ENT",
      "KC_SLSH",
      "KC_DOT",
      "KC_COMM",
      "KC_M",
      "KC_N",
      "KC_NO",
      "KC_RGHT",
      "KC_UP",
      "KC_DOWN",
      "KC_LEFT",
      "KC_PMNS",
      "KC_PEQL",
      "MO(2)"
    ],
    [
      "KC_TRNS",
      "KC_1",
      "KC_2",
      "KC_3",
      "KC_4",
      "KC_5",
      "KC_NO",
      "KC_TRNS",
      "KC_TRNS",
      "KC_LT",
      "KC_LCBR",
      "KC_LBRC",
      "KC_LPRN",
      "KC_NO",
      "KC_TRNS",
      "KC_TRNS",
      "KC_TRNS",
      "KC_TRNS",
      "KC_TRNS",
      "KC_TRNS",
      "KC_TRNS",
      "KC_TRNS",
      "KC_TRNS",
      "KC_TRNS",
      "KC_TRNS",
      "KC_TRNS",
      "KC_TRNS",
      "KC_TRNS",
      "KC_TRNS",
      "KC_0",
      "KC_9",
      "KC_8",
      "KC_7",
      "KC_6",
      "KC_NO",
      "KC_TRNS",
      "KC_TRNS",
      "KC_GT",
      "KC_RCBR",
      "KC_RBRC",
      "KC_RPRN",
      "KC_NO",
      "KC_TRNS",
      "KC_TRNS",
      "KC_TRNS",
      "KC_TRNS",
      "KC_TRNS",
      "KC_TRNS",
      "KC_TRNS",
      "KC_TRNS",
      "KC_TRNS",
      "KC_TRNS",
      "KC_UNDS",
      "KC_TRNS",
      "KC_TRNS",
      "KC_PPLS"
    ],
    [
      "KC_TILD",
      "KC_EXLM",
      "KC_AT",
      "KC_HASH",
      "KC_DLR",
      "KC_PERC",
      "KC_NO",
      "KC_TRNS",
      "KC_TRNS",
      "KC_LT",
      "KC_LCBR",
      "KC_LBRC",
      "KC_LPRN",
      "KC_NO",
      "KC_TRNS",
      "KC_TRNS",
      "KC_TRNS",
      "KC_TRNS",
      "KC_TRNS",
      "KC_TRNS",
      "KC_TRNS",
      "KC_TRNS",
      "KC_TRNS",
      "KC_TRNS",
      "KC_TRNS",
      "KC_TRNS",
      "KC_TRNS",
      "KC_TRNS",
      "KC_TRNS",
      "KC_RPRN",
      "KC_LPRN",
      "KC_ASTR",
      "KC_AMPR",
      "KC_CIRC",
      "KC_NO",
      "KC_GRV",
      "KC_PIPE",
      "KC_GT",
      "KC_RCBR",
      "KC_RBRC",
      "KC_RPRN",
      "KC_NO",
      "KC_TRNS",
      "KC_BSLS",
      "KC_TRNS",
      "KC_TRNS",
      "KC_TRNS",
      "KC_TRNS",
      "KC_TRNS",
      "KC_TRNS",
      "KC_TRNS",
      "KC_TRNS",
      "KC_TRNS",
      "KC_TRNS",
      "KC_TRNS",
      "KC_TRNS"
    ],
    [
      "KC_TRNS",
      "KC_TRNS",
      "KC_TRNS",
      "KC_TRNS",
      "KC_TRNS",
      "KC_TRNS",
      "KC_NO",
      "KC_TRNS",
      "KC_TRNS",
      "KC_TRNS",
      "KC_TRNS",
      "KC_TRNS",
      "KC_TRNS",
      "KC_NO",
      "KC_TRNS",
      "KC_TRNS",
      "KC_TRNS",
      "KC_TRNS",
      "KC_TRNS",
      "KC_TRNS",
      "KC_TRNS",
      "KC_TRNS",
      "KC_TRNS",
      "KC_TRNS",
      "KC_TRNS",
      "KC_TRNS",
      "KC_TRNS",
      "KC_TRNS",
      "KC_TRNS",
      "KC_TRNS",
      "KC_TRNS",
      "KC_TRNS",
      "KC_TRNS",
      "KC_TRNS",
      "KC_NO",
      "KC_TRNS",
      "KC_TRNS",
      "KC_TRNS",
      "KC_TRNS",
      "KC_TRNS",
      "KC_TRNS",
      "KC_NO",
      "KC_TRNS",
      "KC_TRNS",
      "KC_TRNS",
      "KC_TRNS",
      "KC_TRNS",
      "KC_TRNS",
      "KC_TRNS",
      "KC_TRNS",
      "KC_TRNS",
      "KC_TRNS",
      "KC_TRNS",
      "KC_TRNS",
      "KC_TRNS",
      "KC_TRNS"
    ]
  ]
}